1000000000000000000000000-
1111100000000000000000000-
0000100111000000000000000-
0000111101000000000000000-
0000000001000111000000000-
0000011111011101000000000-
0000010000010001000000000-
0000011111110001000000000-
0000000000000001111000000-
0000000000000000001100000-
0000000000000001111000000
