10000000000000000000-
11111000000000000000-
00001001110000000000-
00001111010000000000-
00000000010001110000-
00000111110111010000-
00000100000100010000-
00000111111100010000-
00000000000000011110-
00000000000000000011